32 32
20 15
1
1 0 1 0 1 0 1 0 1 0 1 0 1 0 1 0 1 0 1 2 0 0 0 0 1 0 1 0 1 0 1 0 1 0 1 0 1 0 1 0 
1 0 1 0 1 83 1 0 1 0 1 0 0 83 1 0 1 68 0 0 0 0 0 0 0 0 1 0 0 68 1 0 1 0 1 0 1 0 0 83 
1 0 1 0 1 0 0 0 0 0 0 0 0 0 0 0 0 0 0 0 0 0 0 0 0 0 0 0 0 0 0 0 0 0 0 0 1 0 1 70 
1 0 1 0 1 68 0 0 0 0 0 0 0 0 0 0 0 0 0 0 0 0 0 0 0 0 0 0 0 0 0 0 0 0 0 0 0 0 0 0 
1 0 1 1 1 1 0 0 0 0 0 0 0 0 0 0 0 0 0 0 0 0 0 0 0 0 0 0 0 0 0 0 0 0 0 0 0 0 0 0 
1 0 1 1 0 0 0 0 0 0 1 0 1 0 1 0 1 89 1 0 1 0 1 89 1 89 1 0 0 0 0 0 0 0 0 0 1 0 1 0 
0 0 0 0 0 0 0 0 1 0 1 86 0 0 0 0 0 0 0 0 0 0 0 0 0 0 1 0 1 87 0 0 0 0 0 0 1 0 1 70 
0 0 0 0 0 0 1 0 0 86 0 0 0 0 0 0 0 0 0 0 0 0 0 0 0 0 1 0 1 0 1 87 0 0 0 0 1 0 1 68 
1 0 1 0 0 0 1 0 1 87 0 0 0 0 0 0 0 0 0 0 0 0 0 0 1 0 1 86 1 86 0 0 0 0 0 0 1 0 1 68 
1 0 1 70 0 0 0 0 1 0 1 87 0 0 0 0 0 0 0 0 0 0 1 0 0 86 1 86 0 0 0 0 0 0 0 0 1 0 1 70 
1 0 1 70 0 0 0 0 0 0 1 0 1 87 0 0 0 0 0 0 0 0 1 0 1 86 0 0 0 0 0 0 0 0 0 0 1 0 1 0 
1 70 1 70 0 0 0 0 0 0 0 0 1 0 1 87 0 0 0 0 1 0 0 86 0 0 0 0 0 0 1 0 1 0 1 0 1 0 1 70 
1 0 1 0 1 0 1 0 0 0 0 0 0 0 0 0 0 0 0 0 0 0 0 0 0 0 0 0 0 0 1 0 1 0 1 94 1 0 1 68 
1 0 1 0 1 0 1 0 1 0 1 0 1 30 0 0 0 0 0 0 0 0 0 0 0 0 0 0 0 0 0 0 1 0 1 0 1 0 1 0 
1 0 1 0 1 0 1 83 1 0 0 85 1 77 1 77 0 0 0 0 1 0 0 22 1 0 1 22 1 22 0 0 1 0 1 0 1 0 1 83 
