32 32
32 15
3
0 0 1 4 1 4 1 0 1 4 1 4 1 0 1 0 1 4 1 0 1 4 1 0 1 0 1 0 1 4 0 0 0 0 0 0 1 0 1 4 1 0 1 4 1 4 1 0 1 4 1 4 1 0 1 4 1 4 1 0 1 4 1 0 
0 0 1 0 1 0 0 6 0 0 1 0 1 4 1 0 1 4 0 0 1 0 1 4 1 4 1 4 0 0 0 0 0 0 0 0 1 0 1 4 1 4 0 0 0 0 0 0 0 0 0 0 1 0 1 4 0 0 1 0 1 4 1 0 
0 0 1 0 1 4 0 6 0 0 0 0 0 0 0 0 0 0 0 0 1 0 1 1 0 0 0 0 0 0 0 0 0 0 1 0 1 4 0 0 0 0 0 0 0 0 0 0 0 0 0 0 1 0 1 4 0 0 0 0 1 0 1 4 
0 0 1 0 1 4 0 0 0 0 0 0 0 0 0 0 0 0 0 0 0 0 1 0 1 4 0 0 0 0 0 0 0 0 0 0 0 0 0 0 0 0 0 0 1 0 1 4 1 4 0 0 0 0 0 0 0 0 1 0 1 4 1 0 
0 0 0 0 1 0 0 4 0 0 0 0 0 0 0 0 0 0 0 0 0 0 1 0 1 4 0 0 0 0 0 0 0 0 0 0 1 0 1 4 0 0 1 0 1 4 0 0 1 0 1 4 0 0 0 0 0 0 1 0 1 4 1 0 
0 0 1 0 1 4 1 4 0 0 1 0 1 2 1 2 1 2 1 2 0 0 0 0 1 0 1 4 0 0 0 0 0 0 0 0 0 0 1 0 1 4 1 4 0 4 0 0 1 0 1 1 0 0 0 0 0 0 0 0 1 0 1 4 
0 0 0 0 0 0 1 0 1 4 0 2 0 0 0 0 0 0 0 0 0 0 1 0 1 4 0 0 0 0 0 0 1 0 1 4 1 0 1 4 0 0 0 0 0 0 1 1 1 1 0 0 0 0 0 0 0 0 1 0 1 4 1 0 
0 0 0 0 1 0 1 4 0 0 0 0 1 0 1 2 0 0 0 0 1 0 1 4 1 0 1 0 1 4 1 0 1 4 0 0 0 0 0 0 0 0 0 0 1 0 1 1 0 0 0 0 0 0 0 0 0 0 1 0 1 4 1 0 
0 0 1 0 1 4 0 0 0 0 1 0 1 3 0 0 1 0 1 3 0 0 1 0 1 4 1 0 1 4 0 0 0 0 0 0 0 0 0 0 0 0 0 0 1 0 1 1 0 0 0 0 0 0 0 0 1 0 1 4 1 0 1 4 
0 0 0 0 1 0 1 4 0 0 0 0 1 0 1 3 1 3 1 0 1 3 1 0 1 4 1 6 1 4 0 0 0 0 0 0 0 0 0 0 0 0 0 0 1 0 1 1 0 0 0 0 0 0 0 0 0 0 0 0 1 0 1 4 
0 0 0 0 1 0 1 4 0 0 0 0 0 0 0 0 0 0 0 0 0 0 0 0 0 0 0 0 0 0 0 0 0 0 0 0 0 0 0 0 0 0 0 0 0 0 0 0 0 0 0 0 0 0 0 0 0 0 1 0 1 4 1 4 
0 0 1 4 1 2 0 0 0 0 0 0 0 0 1 0 1 4 1 4 0 0 0 0 0 0 0 0 0 0 1 0 1 4 1 4 1 0 1 4 0 0 0 0 1 0 1 4 0 0 1 0 1 4 0 0 0 0 1 0 1 4 1 0 
0 0 1 2 0 0 0 0 0 0 1 0 1 4 1 4 0 0 0 0 1 0 1 4 0 0 0 0 0 0 0 0 0 0 0 0 0 0 0 0 0 0 1 0 1 4 0 0 0 0 0 0 0 0 0 0 0 0 0 0 1 0 1 4 
0 0 1 2 0 0 0 0 0 0 0 0 0 0 0 0 0 0 0 0 0 0 0 0 0 0 1 0 1 4 1 0 1 4 0 0 1 0 1 4 1 0 1 4 0 0 0 0 0 0 1 0 1 4 1 4 1 0 1 4 1 0 1 4 
0 0 1 2 1 2 1 0 1 4 1 0 1 4 1 4 1 0 1 4 1 0 1 4 1 4 1 4 1 0 1 4 1 0 1 0 1 4 1 0 1 0 1 0 1 0 1 4 1 0 1 4 1 0 1 4 1 0 1 0 1 4 1 0 
