32 32
20 24
2
0 0 0 0 0 0 0 0 0 0 0 0 0 0 0 0 0 0 0 0 0 0 0 0 0 0 0 0 0 0 0 0 0 0 0 0 0 0 0 0 
0 0 0 74 0 74 0 0 0 0 0 0 0 0 0 0 0 0 0 0 0 0 0 0 0 0 0 0 0 0 0 0 0 0 0 0 0 0 0 0 
0 0 0 0 0 0 0 0 0 0 0 0 0 0 0 0 0 0 0 0 0 0 0 0 0 0 0 0 0 0 0 0 0 0 0 0 0 0 0 0 
1 0 1 74 1 0 1 0 1 74 1 0 1 0 1 74 1 74 1 0 1 74 1 74 1 74 1 0 1 74 1 0 1 74 1 74 1 0 1 0 
1 0 1 0 0 74 0 0 0 74 0 74 0 0 0 0 0 0 0 0 0 0 0 0 1 74 0 0 0 0 0 0 0 0 1 0 1 0 1 74 
1 0 1 74 0 0 0 0 0 0 0 0 0 0 0 0 0 0 0 0 0 0 0 0 0 0 0 0 0 0 0 0 0 0 1 74 1 0 1 74 
1 0 1 74 1 0 0 0 1 39 1 0 0 39 0 39 0 0 0 0 0 0 0 0 0 0 0 0 0 0 0 0 0 0 0 0 0 0 1 0 
1 0 1 74 0 0 0 0 0 0 0 0 0 0 0 0 0 0 0 0 0 0 0 0 0 0 0 0 0 0 0 0 0 0 0 0 0 0 1 74 
1 0 1 0 0 0 0 0 0 0 0 0 0 0 0 0 0 0 0 0 1 0 0 58 0 0 0 0 0 0 0 0 0 0 0 0 0 0 1 0 
1 0 1 74 0 0 0 0 0 0 0 0 0 0 0 0 0 0 0 0 0 0 0 0 0 0 1 38 0 0 0 0 0 0 0 0 0 0 1 74 
1 0 1 74 0 0 0 0 0 0 0 0 0 0 0 0 0 0 0 0 0 0 0 0 0 0 0 0 0 0 0 0 0 0 0 0 1 74 0 0 
1 0 1 74 0 0 0 0 0 0 0 0 0 0 0 0 0 0 1 0 0 36 0 0 0 0 0 0 0 0 0 0 0 0 0 0 0 0 0 0 
1 0 1 74 0 39 0 0 0 0 0 0 1 0 0 0 0 39 0 0 0 0 0 0 0 0 0 0 0 0 0 0 0 0 0 0 0 0 0 0 
1 0 1 74 0 0 0 0 0 0 0 0 0 0 0 0 0 0 0 0 0 95 0 0 0 0 1 38 0 0 0 0 0 0 0 0 0 0 1 0 
1 0 1 74 0 0 0 0 0 0 0 0 0 0 0 0 0 95 0 0 0 95 0 95 0 0 0 0 0 0 0 0 0 0 0 0 0 0 1 74 
1 0 1 0 0 74 0 0 0 0 0 0 0 0 0 0 0 0 0 95 0 0 0 95 0 0 0 0 0 0 0 0 0 0 0 0 0 0 1 0 
1 74 1 0 0 74 0 0 0 0 0 0 0 0 0 0 0 0 0 0 0 0 0 0 0 0 0 0 0 0 0 0 0 0 0 0 0 0 1 74 
1 0 1 74 0 0 0 0 0 0 0 0 0 0 0 0 1 0 0 58 0 0 0 0 0 0 0 0 0 0 0 0 0 0 0 0 0 0 1 0 
1 0 1 0 0 74 0 0 0 0 0 0 0 0 0 0 0 0 0 0 0 0 0 0 0 0 0 0 0 0 0 0 1 0 0 58 1 0 1 74 
1 0 1 74 1 0 0 0 0 39 0 0 0 0 0 0 0 0 0 0 0 0 0 0 0 0 0 0 0 0 0 0 0 0 1 0 1 74 1 74 
1 0 1 74 1 74 0 0 0 0 0 0 1 0 0 0 0 39 0 0 0 0 0 0 0 0 0 0 0 0 0 0 0 0 1 74 1 0 1 0 
1 0 1 0 0 0 0 0 0 0 0 0 0 0 0 0 0 0 0 0 0 0 0 0 0 0 0 0 0 0 0 0 0 0 0 0 1 74 1 74 
1 74 1 73 1 74 1 0 1 0 0 0 1 0 1 0 0 0 0 0 1 0 1 0 1 0 1 0 1 0 1 0 1 0 1 74 1 0 1 0 
1 74 1 74 1 73 1 74 1 73 1 74 1 74 1 73 1 74 1 0 1 74 1 74 1 0 1 74 1 0 1 74 1 0 0 74 1 0 1 74 
