32 32
20 15
0
0 0 0 0 0 1 1 1 1 1 1 1 1 0 0 0 0 0 0 0 
0 0 0 0 0 0 1 1 1 1 1 1 1 0 0 0 0 0 0 0 
0 0 0 0 0 0 0 0 0 0 0 0 0 0 0 0 0 0 0 0 
0 0 1 1 0 0 0 0 0 0 0 0 0 0 0 0 0 0 0 0 
0 0 0 0 0 0 0 0 0 0 0 0 0 0 0 0 0 0 0 0 
0 0 0 0 0 1 1 1 1 1 1 0 0 0 0 0 0 0 0 0 
0 0 0 0 0 1 1 1 1 1 1 1 0 0 0 0 0 0 0 0 
0 0 0 1 1 1 1 1 1 1 0 0 0 0 0 0 0 0 0 0 
0 0 0 0 1 1 1 1 1 1 1 1 0 0 0 0 1 1 0 0 
0 0 0 0 0 0 0 1 1 1 1 1 1 0 0 0 0 1 0 0 
0 0 1 1 0 0 0 0 0 0 0 0 0 0 0 0 0 0 0 0 
0 0 0 0 0 0 0 0 0 0 0 0 0 0 0 0 0 0 0 0 
0 0 0 0 0 0 0 0 0 0 0 0 0 0 0 0 0 0 0 0 
0 1 1 1 1 1 1 0 0 0 1 1 1 1 1 0 0 0 0 0 
0 1 1 1 1 1 0 0 0 0 0 0 1 1 0 0 0 0 0 1 
0 0 0 0 0 0 0 76 76 76 76 76 76 0 0 0 0 0 0 0 
0 0 0 0 0 0 76 76 76 76 76 76 76 0 0 0 0 0 0 0 
0 0 0 0 0 0 0 0 0 0 0 0 0 0 0 0 0 0 0 0 
0 0 0 17 17 0 0 0 0 0 0 0 0 0 0 0 0 0 0 0 
0 0 0 0 0 0 0 0 0 0 0 0 0 0 0 0 0 0 0 0 
0 0 0 0 0 0 0 0 0 61 61 0 0 0 0 0 0 0 0 0 
0 0 0 0 0 0 20 20 20 61 61 61 0 0 0 0 0 0 0 0 
0 0 0 0 64 20 20 20 20 20 0 0 0 0 0 0 0 0 0 0 
0 0 0 0 64 64 64 64 64 78 6 0 0 0 0 0 0 0 0 0 
0 0 0 0 0 0 0 0 6 6 0 0 6 0 0 0 0 0 0 39 
0 0 0 17 17 0 0 0 0 0 0 0 0 0 0 0 0 0 0 0 
0 0 0 0 0 0 0 0 0 0 0 0 0 0 0 0 0 0 0 0 
0 0 0 0 0 0 0 0 0 0 0 0 0 0 0 0 0 0 0 0 
0 0 0 0 0 0 0 0 0 0 0 0 0 0 0 0 0 0 0 0 
0 0 0 0 93 67 67 0 0 98 0 0 0 0 93 0 0 0 0 20 
